#####.###.#.###.
..##.#.##..##...
.#.#####......#.
###.##.###..###.
##...##.#...#.#.
.....######.....
...####.##.....#
..#.#...#######.
.##......#.#....
.#####.##.#.#...
..#.###.#.....#.
###..#.##..####.
.##.#..#.####.##
#..#..#####.#..#
....#....##.#.##
##.####....#..##
