###############################.............##########..........
###############################...............#######...........
##################################..............#####...........
###################################.............................
###################################.............................
###################################.............................
###################################.............................
####################################............................
########################################........................
########################################........................
#########################################.......................
#########################################.......................
##########################################......................
###########################################.....................
############################################....................
########################.#....################.........###......
#########.####.....###............#############.......###.......
######..............##.............############......########...
.####.............................###############...###########.
..###.............................#############################.
...................................#############################
...................................#############################
..................................##############################
.................................###############################
..................................##############################
.................................###############################
.................................###############################
................................################################
................#................###############################
............##....................##############################
............#..#..................##############################
...........####...................##############################
..........###.#....................#############################
.........######.....................############################
......#############.................############################
.....###############...............#############################
....################...............#############################
....#################.............#################.############
....#################...........##################.....#########
....#################..........########..#########......########
....#################..........########...########........######
...##################...........#######...#####.###.........####
...###################............#.##......###.............####
...####################...........#..........................###
.######################......................................###
.#####################................#........................#
.....#################................#........##...............
....###################..........#..####......#.................
....####.##############......#...#######........................
........#################........#########......................
......###.###############.......###########.....................
.....####################........##########.....................
.#....##################.........#########......................
####..#################..........#########......................
####....####.###.#####..........##########......................
...#.....######..#####........############......................
#........######......#.........###########......................
............##...............#############......................
...........................###############......................
..........................###############.......................
..........................###############.......................
......................####################......................
....................######################......................
..................#########################.....................
